16
1072
512
224
0 0 0 0 0 0 0 0 0 0 0 0 0 0 0 0 0 0 0 0 0 0 0 0 0 0 0 0 0 0 0 0 
0 0 0 0 0 0 0 0 0 0 0 0 0 0 0 0 0 0 0 0 0 0 0 0 0 0 0 0 0 0 0 0 
1 2 3 4 5 6 7 8 2 2 5 6 3 4 2 2 7 8 2 2 3 4 7 8 2 2 2 2 3 4 1 1 
9 10 11 12 13 14 15 16 17 10 18 19 20 21 2 2 15 16 22 23 20 21 15 16 17 10 22 23 20 21 1 1 
24 25 26 27 2 2 15 16 28 29 30 31 2 2 2 2 15 16 30 31 2 2 15 16 28 29 30 31 2 2 1 1 
32 33 13 14 22 23 15 16 34 35 20 21 36 37 36 37 15 16 11 12 2 2 15 16 34 35 38 39 2 2 1 1 
40 41 2 2 30 31 42 43 41 44 2 2 45 45 45 45 42 43 26 27 2 2 42 43 41 44 45 45 2 2 1 1 
1 2 2 2 46 47 7 8 1 1 2 2 2 2 1 1 1 2 48 49 17 10 1 1 50 51 17 10 2 2 1 1 
1 2 2 2 41 44 15 16 1 1 2 2 2 2 1 1 1 2 45 45 28 29 1 1 26 27 28 29 52 1 1 1 
1 2 22 23 50 51 15 16 1 1 2 2 22 23 1 1 1 2 2 2 34 35 1 1 13 14 53 54 55 8 1 1 
1 2 30 31 26 27 15 16 1 1 2 2 30 31 1 1 1 2 2 2 41 44 1 1 2 2 56 57 15 16 1 1 
1 2 58 59 13 14 15 16 1 1 2 2 20 21 1 1 1 2 2 2 2 2 2 2 60 61 57 2 15 16 1 1 
1 2 28 29 2 2 15 16 1 1 2 2 2 2 1 1 1 2 2 2 2 2 2 2 56 57 2 2 15 16 1 1 
0 0 62 63 0 0 64 65 0 0 0 0 0 0 0 0 0 0 0 0 0 0 0 0 66 0 0 0 64 65 0 0 
