32
960
512
384
0 0 0 0 0 0 0 0 0 0 0 0 0 0 0 0
0 0 0 0 0 0 0 0 0 0 0 0 0 0 0 0
0 0 0 0 0 0 0 0 0 0 0 0 0 0 0 0 
1 2 3 4 2 2 2 2 5 2 6 7 3 4 1 1 
1 2 3 4 2 2 8 5 2 2 9 10 3 4 1 1 
1 2 3 4 2 2 5 2 2 2 11 12 3 4 1 1 
1 1 3 4 8 5 6 7 13 14 2 2 3 4 1 1 
1 1 1 1 1 1 1 1 1 1 2 2 3 4 1 1 
1 1 3 4 9 10 2 2 2 2 2 2 3 4 1 1 
1 1 3 4 11 12 2 2 2 2 15 1 1 1 1 1 
16 17 3 4 2 2 2 2 8 5 2 2 18 17 1 1 
19 20 3 4 2 2 2 2 5 2 2 2 6 7 1 1 
21 22 3 4 6 7 8 5 13 14 13 14 6 7 1 1 
1 1 1 1 1 1 1 1 1 1 1 1 1 1 1 1 
