32
2496
1536
384
34 34 34 34 34 34 34 34 34 34 34 34 34 34 34 34 34 34 34 34 34 34 34 34 34 34 34 34 34 34 34 34 34 34 34 34 34 34 34 34 34 34 34 34 34 34 34 34
34 34 34 34 34 34 34 34 34 34 34 34 34 34 34 34 34 34 34 34 34 34 34 34 34 34 34 34 34 34 34 34 34 34 34 34 34 34 34 34 34 34 34 34 34 34 34 34 
34 34 34 34 34 34 34 34 34 34 34 34 34 34 34 34 34 34 34 34 34 34 34 34 34 34 34 34 34 34 34 34 34 34 34 34 34 34 34 34 34 34 34 34 34 34 34 34 
0 0 1 2 3 3 3 4 1 5 6 6 6 6 6 6 6 6 6 6 6 6 6 6 6 6 6 6 6 6 6 6 6 6 6 6 6 6 6 6 6 6 6 6 6 6 0 0 
0 0 3 7 8 8 9 10 3 11 6 6 6 6 6 6 3 12 3 12 6 6 6 6 6 6 6 6 13 14 6 6 6 6 6 6 6 6 6 6 6 6 3 12 3 12 0 0 
0 0 8 8 8 15 16 17 8 15 6 6 6 6 6 6 18 4 18 4 6 6 6 6 6 6 6 6 19 20 6 6 6 6 6 6 6 6 6 6 21 22 8 4 8 3 0 0 
0 0 8 8 8 23 24 25 26 15 6 6 6 6 13 14 27 28 29 30 13 14 6 6 6 6 6 6 31 32 3 12 3 12 3 12 3 12 33 22 34 34 9 10 8 8 0 0 
0 0 8 8 8 18 35 36 18 18 6 6 6 6 37 20 38 6 6 39 19 40 6 6 6 6 6 6 41 4 8 3 8 3 18 4 18 3 34 34 34 34 42 43 8 8 34 44 
0 0 8 8 9 10 45 32 0 0 6 6 29 30 0 0 6 6 6 6 7 7 13 14 13 14 3 12 46 47 18 18 8 8 0 0 48 49 24 50 51 10 3 3 18 18 34 52 
0 0 8 15 42 53 41 3 0 0 54 6 6 39 3 4 55 56 6 57 8 8 19 58 19 20 18 4 59 60 0 0 8 8 61 24 62 48 63 64 42 43 8 8 0 0 34 65 
0 0 8 8 45 32 3 8 3 66 33 22 33 22 9 10 24 50 36 25 26 8 7 7 31 32 0 0 67 50 13 14 8 8 27 28 29 30 48 68 3 3 18 18 24 50 0 0 
0 0 18 69 70 4 8 18 8 18 34 34 34 34 42 43 63 36 63 36 18 18 18 69 70 3 61 24 63 36 19 58 8 15 38 6 6 39 62 48 18 18 0 0 35 71 0 0 
0 0 0 0 72 0 9 10 9 73 0 0 0 0 0 0 0 0 0 0 13 14 0 0 3 15 6 6 0 0 74 74 18 18 6 6 13 14 0 0 0 0 3 3 3 7 0 0 
0 0 0 0 75 76 42 77 42 43 4 4 61 24 61 24 61 24 4 4 37 20 61 24 18 18 55 56 61 24 0 0 0 0 55 56 37 20 61 24 61 24 18 18 18 18 0 0 
