32
2112
1024
384
0 0 0 0 0 0 0 0 0 0 0 0 0 0 0 0 0 0 0 0 0 0 0 0 0 0 0 0 0 0 0 0
0 0 0 0 0 0 0 0 0 0 0 0 0 0 0 0 0 0 0 0 0 0 0 0 0 0 0 0 0 0 0 0
0 0 0 0 0 0 0 0 0 0 0 0 0 0 0 0 0 0 0 0 0 0 0 0 0 0 0 0 0 0 0 0 
1 2 3 4 5 6 7 8 2 2 5 6 3 4 2 2 7 8 2 2 3 4 7 8 2 2 2 2 3 4 1 1 
9 10 11 12 13 14 15 16 17 10 18 19 20 21 2 2 15 16 22 23 20 21 15 16 17 10 22 23 20 21 1 1 
24 25 26 27 28 2 15 16 29 30 31 32 2 2 2 2 15 16 31 32 2 2 15 16 29 30 31 32 2 2 1 1 
33 34 13 14 22 23 15 35 36 37 20 21 38 39 38 39 15 35 11 12 2 2 15 35 36 37 40 41 2 2 1 1 
42 43 2 2 31 32 44 45 43 46 2 2 47 47 47 47 44 45 26 27 28 2 44 45 43 46 47 47 2 2 1 1 
1 2 2 2 48 49 7 8 1 1 2 2 2 2 1 1 1 2 50 51 17 10 1 1 52 53 17 10 2 2 1 1 
1 2 2 2 43 46 15 16 1 1 2 2 2 2 1 1 1 2 47 47 29 30 1 1 26 54 29 30 55 1 1 1 
1 2 22 23 52 53 15 16 1 1 2 2 22 23 1 1 1 2 2 2 36 37 1 1 13 14 56 57 58 8 1 1 
1 2 31 32 26 54 15 16 1 1 2 2 31 32 1 1 1 2 2 2 43 46 1 1 2 2 59 60 15 16 1 1 
1 2 61 62 13 14 15 16 1 1 2 2 20 21 1 1 1 2 2 2 2 2 2 2 63 64 60 2 15 16 1 1 
1 2 29 30 2 2 15 65 1 1 2 2 2 2 1 1 1 2 2 2 2 2 2 2 59 60 2 2 15 65 1 1 
