32
3488
1536
384
108 108 108 108 108 108 108 108 108 108 108 108 108 108 108 108 108 108 108 108 108 108 108 108 108 108 108 108 108 108 108 108 108 108 108 108 108 108 108 108 108 108 108 108 108 108 108 108
108 108 108 108 108 108 108 108 108 108 108 108 108 108 108 108 108 108 108 108 108 108 108 108 108 108 108 108 108 108 108 108 108 108 108 108 108 108 108 108 108 108 108 108 108 108 108 108 
108 108 108 108 108 108 108 108 108 108 108 108 108 108 108 108 108 108 108 108 108 108 108 108 108 108 108 108 108 108 108 108 108 108 108 108 108 108 108 108 108 108 108 108 108 108 108 108 
0 1 2 3 4 5 6 7 0 3 4 5 8 9 10 3 4 5 11 12 13 14 15 16 0 3 17 18 4 5 19 16 0 3 17 18 4 5 19 16 0 3 20 21 8 22 23 24 
25 26 27 28 4 5 25 29 30 26 4 5 31 31 25 26 4 5 32 33 27 34 25 26 35 36 37 38 4 5 39 40 35 36 37 38 4 5 39 40 35 36 41 42 31 31 43 24 
0 44 6 45 46 47 0 48 2 44 4 5 31 31 0 44 4 5 49 50 51 45 0 44 4 5 17 52 4 5 19 16 4 5 17 52 4 5 19 16 4 5 53 12 31 31 23 24 
54 55 56 56 57 56 58 59 60 61 4 5 31 31 25 26 4 5 62 63 25 29 30 26 4 5 25 26 4 5 25 26 4 5 25 26 4 5 64 65 4 5 66 63 31 31 67 68 
69 69 69 69 69 69 69 70 71 72 46 47 31 31 0 44 46 47 73 74 0 48 2 44 4 5 0 44 4 5 0 44 4 5 0 44 4 5 75 22 4 5 73 74 31 31 67 76 
41 42 25 26 35 36 77 78 70 79 80 56 54 55 56 56 57 56 58 59 60 61 25 26 4 5 25 26 4 5 25 26 4 5 25 26 4 5 27 28 4 5 81 82 83 84 67 85 
53 12 0 44 4 5 13 86 69 69 69 69 69 69 69 69 69 69 69 70 71 87 88 44 4 5 0 44 4 5 0 44 4 5 0 44 4 5 6 45 4 5 89 90 91 69 69 69 
66 63 25 26 4 5 25 26 64 92 4 93 27 28 4 93 27 28 77 78 70 94 60 61 4 5 25 26 4 5 25 26 4 5 25 26 4 5 25 26 4 5 95 91 96 97 43 24 
73 74 0 44 4 98 0 44 99 22 4 98 6 45 4 98 6 45 13 86 100 70 71 72 4 98 0 44 4 98 0 44 4 98 0 44 4 98 0 44 4 98 69 69 101 102 23 24 
54 55 54 55 103 104 54 55 54 55 103 104 54 55 103 104 54 55 54 55 54 55 70 105 106 104 54 55 103 104 54 55 103 104 54 55 103 104 54 55 103 104 54 55 54 55 107 24 
69 69 69 69 69 69 69 69 69 69 69 69 69 69 69 69 69 69 69 69 69 69 69 69 69 69 69 69 69 69 69 69 69 69 69 69 69 69 69 69 69 69 69 69 69 69 69 69 
