32
2784
1536
384
66 66 66 66 66 66 66 66 66 66 66 66 66 66 66 66 66 66 66 66 66 66 66 66 66 66 66 66 66 66 66 66 66 66 66 66 66 66 66 66 66 66 66 66 66 66 66 66 
66 66 66 66 66 66 66 66 66 66 66 66 66 66 66 66 66 66 66 66 66 66 66 66 66 66 66 66 66 66 66 66 66 66 66 66 66 66 66 66 66 66 66 66 66 66 66 66 
66 66 66 66 66 66 66 66 66 66 66 66 66 66 66 66 66 66 66 66 66 66 66 66 66 66 66 66 66 66 66 66 66 66 66 66 66 66 66 66 66 66 66 66 66 66 66 66 
0 0 1 2 3 4 5 6 7 8 9 9 10 11 12 13 1 2 1 2 14 2 1 2 9 5 5 5 14 2 5 5 1 2 1 2 5 5 1 2 5 5 14 2 15 16 17 18 
0 0 19 20 21 6 4 22 9 9 23 23 10 24 25 26 19 20 27 28 29 30 19 20 31 32 27 28 29 30 33 34 19 20 27 28 35 30 36 32 27 28 29 30 37 38 17 18 
0 0 39 40 23 23 41 4 42 23 23 42 10 24 43 44 39 19 15 16 16 45 39 19 7 8 15 16 16 45 12 13 39 46 15 16 16 45 7 8 15 16 16 45 47 48 17 18 
0 0 9 21 23 23 21 6 4 22 31 49 10 24 19 50 51 52 16 16 16 16 51 52 53 20 54 16 55 56 25 26 9 21 54 16 16 16 53 20 16 16 16 16 19 20 17 18 
0 0 23 42 23 23 42 42 57 4 7 58 10 24 59 19 60 8 61 62 63 56 64 8 39 19 65 16 66 66 43 44 23 67 65 16 68 16 39 19 61 62 63 56 39 40 17 18 
0 0 31 52 23 23 0 0 0 0 0 0 10 24 37 69 53 20 37 38 55 70 53 20 51 52 71 16 66 66 19 50 23 67 71 16 72 16 51 52 16 16 66 66 9 21 0 0 
0 0 7 73 23 23 74 53 74 75 74 53 10 24 47 48 39 19 47 48 66 66 39 46 7 8 76 16 66 66 39 19 23 77 76 16 76 16 7 8 61 78 66 66 23 23 66 79 
0 0 0 0 80 23 36 52 9 21 19 20 10 24 19 20 51 49 0 0 53 81 9 21 9 9 0 0 53 81 51 52 23 23 19 20 19 20 53 20 19 20 82 9 23 23 66 83 
0 0 74 75 42 42 7 73 23 23 39 40 10 24 39 46 7 8 74 75 39 40 23 23 23 23 74 75 39 46 7 8 23 23 39 40 39 40 39 40 39 40 42 42 42 42 66 84 
0 0 9 21 0 0 0 0 85 42 5 86 10 24 5 86 5 5 5 86 5 86 42 42 42 42 5 86 5 86 5 5 42 42 5 86 5 86 5 86 5 86 0 0 0 0 0 0 
0 0 42 42 74 53 74 53 0 0 0 0 0 0 0 0 0 0 0 0 0 0 0 0 0 0 0 0 0 0 0 0 0 0 0 0 0 0 0 0 0 0 0 0 0 0 0 0 
